NO ./textures/main/wall_1.xpm
WE ./textures/main/wall_2.xpm
SO ./textures/main/wall_3.xpm
EA ./textures/main/wall_4.xpm

C 5,6,7
F 30,31,32

1111
10E1
1111
