NO ./textures/main/wall_4.xpm
WE ./textures/main/wall_3.xpm
SO ./textures/main/wall_2.xpm
EA ./textures/main/wall_1.xpm

C 5,6,7
F 30,31,32

1111111111
1001
11111111111111111111111111111111111
100000000010000000000000001110000001
1000000000100000000000000000101111101
100000011100000000000000001110000001
100010000000000E00001000000000000001
100000011100000000011000000000000001
100000000000000000001000000000000001
100000000000000000000000000000000001
111111111111111111111111111111111111
111111111111
100000000111
11111111111
1
